Aaron=亚伦
Abel=亚伯
Abraham=亚伯拉罕
Adam=亚当
Adrian=艾德里安
Aidan=艾登
Alva=阿尔瓦
Alex=亚历克斯
Alexander=亚历山大
Alan=艾伦
Albert=艾伯特
Alfred=阿尔弗雷德
Andrew=安德鲁
Andy=安迪
Angus=安格斯
Anthony=安东尼
Apollo=阿波罗
Arnold=阿诺德
Arthur=亚瑟
August=奥古斯特
Austin=奥斯汀	
Ben=本
Benjamin=本杰明
Bert=伯特
Benson=本森
Bill=比尔
Billy=比利
Blake=布莱克
Bob=鲍伯
Bobby=鲍比
Brad=布拉德
Brandon=布兰登
Brant=布兰特
Brent=布伦特
Brian=布赖恩
Bryan=布赖恩
Brown=布朗
Bruce=布鲁斯
Caleb=迦勒
Cameron=卡梅伦
Carl=卡尔
Carlos=卡洛斯
Cary=凯里
Caspar=卡斯帕
Cecil=塞西
Charles=查尔斯
Cheney=採尼
Chris=克里斯
Christian=克里斯蒂安
Christopher=克里斯多夫
Clark=克拉克
Cliff=柯利弗
Cody=科迪
Cole=科尔
Colin=科林
Cosmo=科兹莫	
Daniel=丹尼尔
Denny=丹尼
Darwin=达尔文
David=大卫
Dennis=丹尼斯
Derek=德里克
Dick=狄克
Donald=唐纳德
Douglas=道格拉斯
Duke=杜克
Dylan=迪伦
Eddie=埃迪
Edgar=埃德加
Edison=爱迪生
Edmund=艾德蒙
Edward=爱德华
Edwin=艾德文
Elijah=以利亚
Elliott=艾略特
Elvis=埃尔维斯
Eric=埃里克
Ethan=伊桑
Eugene=柳真
Evan=埃文
Enterprise=企业英语培训	
Ford=福特
Francis=弗兰克思
Frank=弗兰克
Franklin=富兰克林
Fred=弗瑞德
Gabriel=加百利
Gaby=加比
Garfield=加菲尔德
Gary=加里
Gavin=加文
Geoffrey=杰弗裡
George=乔治
Gino=基诺
Glen=格林
Glendon=格林顿
Hank=汉克
Hardy=哈帝
Harrison=哈里森
Harry=哈利
Hayden=海顿
Henry=亨利
Hilton=希尔顿
Hugo=雨果
Hunk=汉克
Howard=霍华德
Henry=亨利
Ian=伊恩
Ignativs=伊格纳缇伍兹
Ivan=伊凡
Isaac=艾萨克
Isaiah=以赛亚
Jack=杰克
Jackson=杰克逊
Jacob=雅各布
James=詹姆士
Jason=詹森
Jay=杰伊
Jeffery=杰弗瑞
Jerome=杰罗姆
Jerry=杰瑞
Jesse=杰西
Jim=吉姆
Jimmy=吉米
Joe=乔
John=约翰
Johnny=约翰尼
Jonathan=乔纳森
Jordan=乔丹
Jose=约瑟夫
Joseph=约瑟夫
Joshua=约书亚
Justin=贾斯汀
Keith=凯斯
Ken=肯
Kennedy=肯尼迪
Kenneth=肯尼斯
Kenny=肯尼
Kevin=凯文
Kyle=凯尔
Lance=兰斯
Larry=拉里
Laurent=劳伦特
Lawrence=劳伦斯
Leander=利安德尔
Lee=李
Leo=雷欧
Leonard=雷纳德
Leopold=利奥波特
Leslie=莱斯利
Loren=劳伦
Lori=劳瑞
Lorin=劳瑞恩
Louis=路易斯
Luke=卢克
Marcus=马库斯
Marcy=马西
Mark=马克
Marks=马科斯
Mars=马尔斯
Marshal=马歇尔
Martin=马丁
Marvin=马文
Mason=梅森
Matthew=马修
Max=马克斯
Michael=迈克尔
Mickey=米奇
Mike=麦克
Nathan=纳撒尼尔
Nathaniel=纳撒尼尔
Neil=尼尔
Nelson=尼尔森
Nicholas=尼古拉斯
Nick=尼克
Noah=诺亚
Norman=诺曼
Oliver=奥利弗
Oscar=奥斯卡
Owen=欧文
Patrick=帕特里克
Paul=保罗
Peter=彼得
Philip=菲利普
Phoebe=菲比
Quentin=昆廷	
Randall=兰德尔
Randolph=伦道夫
Randy=兰迪
Ray=雷
Raymond=雷蒙德
Reed=列得
Rex=雷克斯
Richard=理查德
Richie=里奇
Riley=赖利
Robert=罗伯特
Robin=罗宾
Robinson=罗宾逊
Rock=洛克
Roger=罗杰
Ronald=罗纳德
Rowan=罗文
Roy=罗伊
Ryan=赖安
Sam=萨姆
Sammy=萨米
Samuel=塞缪尔
Scott=斯考特
Sean=肖恩
Shawn=肖恩
Sidney=西德尼
Simon=西蒙
Solomon=所罗门
Spark=斯帕克
Spencer=斯宾塞
Spike=斯派克
Stanley=斯坦利
Steve=史蒂夫
Steven=史蒂文
Stewart=斯图尔特
Stuart=斯图亚特	
Terence=特伦斯
Terry=特里
Ted=泰德
Thomas=托马斯
Tim=提姆
Timothy=蒂莫西
Todd=托德
Tommy=汤米
Tom=汤姆
Thomas=托马斯
Tony=托尼
Tyler=泰勒
Ultraman=奥特曼
Ulysses=尤利塞斯
Van=范
Vern=弗恩
Vernon=弗农
Victor=维克多
Vincent=文森特
Warner=华纳
Warren=沃伦
Wayne=韦恩
Wesley=卫斯理
William=威廉
Willy=威利
Zack=扎克
Zachary=圣扎迦利