Abigail=阿比盖尔
Abby=艾比
Ada=艾达
Adelaide=阿德莱德
Adeline=艾德琳
Alexandra=亚历桑德拉
Ailsa=艾丽莎
Aimee=艾米
Alexis=亚历克西斯
Alice=爱丽丝
Alicia=艾丽西娅
Alina=艾琳娜
Allison=艾莉森
Alyssa=艾莉莎
Amanda=阿曼达
Amy=艾美
Amber=安伯
Anastasia=阿纳斯塔西娅
Andrea=安德莉亚
Angel=安琪
Angela=安吉拉
Angelia=安吉莉亚
Angelina=安吉莉娜
Ann=安
Anna=安娜
Anne=安妮
Annie=安妮
Anita=安尼塔
Ariel=艾莉尔
April=阿普里尔
Ashley=艾许莉
Audrey=欧蕊
Aviva=阿维娃
Barbara=笆笆拉
Barbie=芭比
Beata=贝亚特
Beatrice=比阿特丽斯
Becky=贝基
Bella=贝拉
Bess=贝斯
Bette=贝蒂
Betty=贝蒂
Blanche=布兰奇
Bonnie=邦妮
Brenda=布伦达
Brianna=布莱安娜
Britney=布兰妮
Brittany=布列塔尼
Camille=卡米尔
Candice=莰蒂丝
Candy=坎蒂
Carina=卡瑞娜
Carmen=卡门
Carol=凯罗尔
Caroline=卡罗琳
Carry=凯丽
Carrie=凯莉
Cassandra=卡桑德拉
Cassie=凯西
Catherine=凯瑟琳
Cathy=凯茜
Chelsea=切尔西
Charlene=沙琳
Charlotte=夏洛特
Cherry=切莉
Cheryl=雪莉尔
Chloe=克洛伊
Chris=克莉丝
Christina=克里斯蒂娜
Christine=克里斯汀
Christy=克里斯蒂
Cindy=辛迪
Claire=克莱尔
Clair=克莱尔
Claudia=克劳迪娅
Clement=克莱门特
Cloris=克劳瑞丝
Connie=康妮
Constance=康斯坦斯
Cora=科拉
Corrine=科瑞恩
Crystal=科瑞斯特尔
Daisy=戴茜
Daphne=达芙妮
Darcy=达茜
Dave=戴夫
Debbie=黛比
Deborah=黛博拉
Debra=黛布拉
Demi=黛米
Diana=黛安娜
Dolores=德洛丽丝
Donna=堂娜
Dora=多拉
Doris=桃瑞丝
Edith=伊迪丝
Editha=伊迪萨
Elaine=伊莱恩
Eleanor=埃莉诺
Elizabeth=伊丽莎白
Ella=埃拉
Ellen=爱伦
Ellie=艾莉
Emerald=艾米瑞达
Emily=艾米丽
Emma=艾玛
Enid=伊妮德
Elsa=埃尔莎
Erica=埃莉卡
Estelle=爱斯特尔
Esther=爱丝特
Eudora=尤杜拉
Eva=伊娃
Eve=伊芙
Evelyn=伊夫林
Fannie=芬妮
Fay=费怡
Fiona=菲奥纳
Flora=福罗拉
Florence=弗罗伦丝
Frances=弗郎西丝
Frederica=弗雷德里卡
Frieda=弗里达
Flta=上海英语外教
Gina=吉娜
Gillian=吉莉安
Gladys=格拉蒂丝
Gloria=格罗瑞娅
Grace=格瑞丝
Grace=格瑞丝
Greta=格瑞塔
Gwendolyn=格温多琳
Hannah=汉娜
Haley=海莉
Hebe=赫柏
Helena=海伦娜
Hellen=海伦
Henna=汉纳
Heidi=海蒂
Hillary=希拉里
Ingrid=英格丽德
Isabella=伊莎贝拉
Ishara=爱沙拉
Irene=艾琳
Iris=艾丽丝
Ivy=艾维
Jacqueline=杰奎琳
Jade=小玉
Jamie=詹米
Jane=简
Janet=珍妮特
Jasmine=贾斯敏
Jean=姬恩
Jenna=珍娜
Jennifer=詹妮弗
Jenny=詹妮
Jessica=杰西卡
Jessie=杰西
Jill=姬尔
Joan=琼
Joanna=乔安娜
Jocelyn=乔斯林
Joliet=乔莉埃特
Josephine=约瑟芬
Josie=乔茜
Joy=乔伊
Joyce=乔伊斯
Judith=朱迪丝
Judy=朱蒂
Julia=朱莉娅
Juliana=朱莉安娜
Julie=朱莉
June=朱恩	
Karen=凯琳
Karida=卡瑞达
Katherine=凯瑟琳
Kate=凯特
Kathy=凯西
Katie=卡蒂
Kate=卡蒂
Katy=卡蒂
Katrina=卡特里娜
Kay=凯
Kayla=凯拉
Kelly=凯莉
Kelsey=凯尔西
Kimberly=特里娜
Kitty=基蒂
Lareina=莱瑞拉
Lassie=蕾西
Laura=劳拉
Lauren=罗兰
Lena=莉娜
Lydia=莉迪娅
Lillian=莉莲
Lily=莉莉
Linda=琳达
lindsay=琳赛
Lisa=丽莎
Liz=莉兹
Lora=洛拉
Laura=洛拉
Lorraine=罗琳
Louisa=路易莎
Louise=路易丝
Lucia=露西娅
Lucy=露茜
Lucine=露西妮
Lulu=露露
Lydia=莉迪娅
Lynn=林恩
Mabel=梅布尔
Madeline=马德琳
Maggie=玛姬
Mamie=玛米
Manda=曼达
Mandy=曼迪
Margaret=玛格丽特
Mariah=玛丽亚
Marilyn=玛里琳
Martha=玛莎
Mavis=梅维丝
Mary=玛丽
Matilda=玛蒂尔达
Maureen=莫琳
Mavis=梅维丝
Maxine=玛克辛
May=梅
Mayme=梅米
Megan=梅甘
Melinda=梅琳达
Melissa=梅利莎
Melody=美洛蒂
Mercedes=默西迪丝
Meredith=梅瑞狄斯
Mia=米娅
Michelle=米歇尔
Milly=米莉
Miranda=米兰达
Miriam=米里亚姆
Miya=米娅
Molly=茉莉
Monica=莫尼卡
Morgan=摩尔根
Nancy=南茜
Natalie=娜塔莉
Natasha=娜塔莎
Nicole=妮可
Nikita=尼基塔
Nina=尼娜
Nora=娜拉
Norma=诺玛
Nydia=尼迪亚
Octavia=奥克塔维亚
Olina=奥琳娜
Olivia=奥利维亚
Ophelia=奥菲莉娅
Oprah=奥帕
Pamela=帕梅拉
Patricia=帕特丽夏
Patty=芭迪
Paula=保拉
Pauline=波琳
Pearl=珀尔
Peggy=帕姬
Philomena=菲洛米娜
Phoebe=菲比
Phyllis=菲丽丝
Polly=波莉
Priscilla=普里西拉
Quentina=昆蒂娜
Rachel=雷切尔
Rebecca=丽贝卡
Regina=瑞加娜
Rita=丽塔
Rose=罗丝
Roxanne=洛克萨妮
Ruth=露丝	
Sabrina=萨布丽娜
Sally=萨莉
Sandra=桑德拉
Samantha=萨曼莎
Sami=萨米
Sandra=桑德拉
Sandy=桑迪
Sarah=莎拉
Sara=莎拉
Savannah=萨瓦纳
Scarlett=斯佳丽
Selma=塞尔玛
Selina=塞琳娜
Serena=塞丽娜
Sharon=莎伦
Sheila=希拉
Shelley=雪莉
Shelly=雪莉
Sherry=雪丽
Shirley=雪莉
Sierra=斯莱瑞
Silvia=西尔维亚
Sonia=索尼亚
Sophia=索菲娅
Stacy=丝塔茜
Stella=丝特拉
Stephanie=斯蒂芬妮
Sue=苏
Sunny=萨妮
Susan=苏珊
Tamara=塔玛拉
Tammy=苔米
Tanya=谭雅坦尼娅
Tasha=塔莎
Teresa=特莉萨
Tess=苔丝
Tiffany=蒂凡妮
Tina=蒂娜
Tonya=棠雅
Tracy=特蕾西
Ursula=厄休拉
Vanessa=温妮莎
Venus=维纳斯
Vera=维拉
Vicky=维姬
Victoria=维多利亚
Violet=维尔莉特
Virginia=维吉妮亚
Vita=维达
Vivian=薇薇安